10
7
_.#.A__A__
__#___D___
P__I______
__#_G__S__
..#_______
IIIIIIII__
__________