20
20
_____________________
_____A________A______
___________________A_
_____________________
___F_________S_______
______________B______
_____________________
___F_____P___I___BS__
_____________________
__________.._________
___S_B____________BB_
______________A______
______.______________
______.____________A_
____.....####III_____
______.______________
__B__.___________F__
_____________________
_____________________
_____________________
