10
7
_.#.A__A__
__#___D___
P__I______
__#_G__S__
..#_~~____
IIIIIIII__
_____~~___