15
15
###############
#_____________#
#____P____S___#
#________B_...#
#.III.......__#
#_____B__.____#
#________.____#
#_B______.____#
#__.__________#
#__.___B______#
#...______F___#
#_____________#
#_____________#
#_____________#
#_____________#
###############