20
20
..#.A..#....#....#..
..#....#....#....#..
P......#....#....#..
..#.........#....#..
..#....#....#....#..
..#....#....#....#..
..#....#.........#..
.......#....#....#..
..#....#....#....#..
..#....#....#....#..
