26
15
#########################
#AB B#__J____~___I______#
#___J#__B________I______#
#B___B_______D___I______#
#F__B########~~~~I____G_#
#___S~___B_II~~~~I______#
#P______A__II~~~~I______#
#____D_____IIIIIII____G_#
#____________B___I______#
#____~____IIIII__I______#
#___~~~______IIS_I____G_#
#___~~~___IIIIIB_I______#
#__~~~~~__II_____I______#
#__~~~~~__IIIII__I______#
#########################