15
10
##############
#__B__B__I_A_#
#_A__B  BI_B_#
#____B___I___#
#G_______I__P#
#J_B_____I___#
#B____B__I___#
#.._____BI__S#
#G.___B__I_B_#
##############