24
11
#######################
#__FB__I_J_._AB_I__A__#
#______I_B_.____I___B_#
#__##D##___.____I_____#
#__#___#___.____IFB___#
#__#_G_#___.____I____P#
#__#___#___.____I_____#
#BB#####___.____I_____#
#__________.____I__B_S#
#BBB_______.JB__I_____#
#######################