26
15
#########################
#AB B#__J____~___I______#
#___J#__B________I______#
#B___B_______D_ABI______#
#F__B########~~~~I______#
#___S~__AB_II~~~~I______#
#P_________II~~~~I______#
#____D_____IIIIIII____G_#
#____________B___I______#
#____~____IIIII__I______#
#___~~~______IIS_I______#
#___~~~___IIIIIB_I______#
#__~~~~~__II_____I______#
#__~~~~~__IIIII__I______#
#########################