15
10
##############
#_B__JB__I_A_#
#_A__B__BI_B_#
#____B___I___#
#G_______I__P#
#JB______I___#
#B____B__I___#
#.._____BI_S_#
#G.____F_I_B_#
##############