15
9
##############
#JB__B_IFSI~~#
#____JBIIII~~#
#__BA__I___~G#
#P_____D___~G#
#______S___~G#
#B__F__I__B~~#
#F___B_I__S~~#
##############