22
10
#####################
#___I___I___~~~__#~~#
#BA_I___I___~~~__#~~#
#___ISB_I_B_~~~B_#~~#
#_SBI___I_B_~~~__####
#P__I___I_A_B______G#
#___I__BI___~~~__####
#_BFI__J~___~~~_B#~~#
#___D___~___~~~__#~~#
#_______~___~~~B_#~~#
#####################