16
8
###############
#BF__~__I__D_G#
#_B__~_DI_____#
#_J__~__I____##
#P___~__I____~#
#_A__~__I__D_~#
#_B__~BSI__BB~#
###############