24
11
#######################
#__FB__I_J_~_AB_I__A__#
#______I_B_~____I__B__#
#__#_D_#___~____I_____#
#__#___#___~____IFB___#
#__#_G_#___~____I____P#
#__#___#___~____I_____#
#BB#####___~____I_____#
#__________~____I__BS_#
#BBB_______~JB__I_____#
#######################