22
10
#####################
#___I___I___...__#..#
#B_AI___I___...__#..#
#___ISB_I_B_...B_#..#
#_SBI___I___...__####
#P__I___I_A___K____G#
#___I___I___...__####
#B_FIB_J.___..._B#..#
#___D___.___...__#..#
#___I___.___...B_#..#
#####################