26
15
#########################
#AB B#__J____.___I______#
#___J#__B____.___I______#
#B___B_______D___I______#
#F__B########....I____G_#
#___S.___B_II....I______#
#P___D__A__II....I______#
#____._____IIIIIII____G_#
#____._______B___I______#
#___...___IIIII__I______#
#___...______IIS_I____G_#
#__.....__IIIIIB_I______#
#__.....__II_____I______#
#__.....__IIIII__I______#
#########################